1111111111111
10010000000C1
1000000000011
1P001100000E1
1111111111111